d0000000000s0000s0000
--0000000000000000000
--0000000000000000000
--0000000000000000000
003000000000000000000
000000000000000000000
000000000000000000000
000000000000000000000
00000r000000000r00000
000800080000800008000
000000000000000000000
000900080000900008000
000000000000000000000
000000000000000000000
000000000000000000000