00000000000f0000f0000
cc0000000000000000000
cc0000000000000000000
cc00000000f0000f00000
00l000000000000000000
0000000000000000f0000
000000000000000000000
000000000000000000000
000000000000000000000
00000000f0000000f0000
000000000000000000000
000000000000000000000
000000f00000000f00000
000000000000000000000
d00000000000000000000