000000000000000000000000000000000000000000000000000000000000000000000
001121111001133311111000000000000000000000000000000000000000000000000
001121111001133311111000000000000000000000000000000000000000000000000
001111111111111111111000000000000000000000000000000000000000000000000
003332111111133311111000000000000000000000000000000000000000000000000
003332111111133311111000000000000000000000000000000000000000000000000
002221111111122211111000000000000000000000000000000000000000000000000
000000000000000000000000000000000000000000000000000000000000000000000
000000000000000000000000000000000000000000000000000000000000000000000
000000000000000000000000000000000000000000000000000000000000000000000
000000000000000000000000000000000000000000000000000000000000000000000
000000000000000000000000000000000000000000000000000000000000000000000
000000000000000000000000000000000000000000000000000000000000000000000
000000000000000000000000000000000000000000000000000000000000000000000
000000000000000000000000000000000000000000000000000000000000000000000
000000000000000000000000000000000000000000000000000000000000000000000
000000000000000000000000000000000000000000000000000000000000000000000